15 15
2 2 2 2 2 2 2 2 2 2 2 2 2 2 2
2 0 0 0 0 1 0 1 0 0 0 0 0 0 2
2 0 2 0 2 1 2 1 2 1 2 1 2 1 2
2 1 1 0 1 1 1 1 1 0 0 0 1 1 2
2 0 2 1 2 0 2 1 2 0 2 0 2 0 2
2 1 0 0 0 0 0 1 0 1 0 0 0 0 2
2 0 2 1 2 0 2 1 2 0 2 0 2 0 2
2 0 0 0 0 0 1 0 0 0 0 0 0 0 2
2 0 2 0 2 0 2 0 2 1 2 0 2 0 2
2 1 0 1 0 1 0 0 1 1 1 0 0 0 2
2 0 2 1 2 1 2 1 2 1 2 1 2 0 2
2 1 0 0 1 1 1 0 0 0 0 0 1 1 2
2 1 2 0 2 0 2 1 2 1 2 1 2 0 2
2 0 0 1 0 1 1 0 0 0 0 0 1 1 2
2 2 2 2 2 2 2 2 2 2 2 2 2 2 2
7 1
4
0
8 3
3
8 5
6 6
2 5
0
7 11
1
6 6
0
1 13
2
4 12
2 12
0
13 1
2
6 10
8 12