15 15
2 2 2 2 2 2 2 2 2 2 2 2 2 2 2
2 0 0 0 0 0 0 1 0 0 0 0 0 0 2
2 0 2 0 2 0 2 1 2 1 2 1 2 1 2
2 1 1 0 1 1 1 1 1 0 0 0 1 1 2
2 0 2 1 2 0 2 1 2 0 2 0 2 0 2
2 1 0 0 0 0 0 1 0 1 0 0 0 0 2
2 0 2 1 2 0 2 1 2 0 2 0 2 0 2
2 0 0 0 0 0 1 0 0 0 0 0 0 0 2
2 0 2 0 2 0 2 0 2 1 2 0 2 0 2
2 1 0 1 0 1 0 0 1 1 1 0 0 0 2
2 0 2 1 2 1 2 1 2 0 2 1 2 0 2
2 1 0 1 1 1 1 0 0 0 0 1 1 1 2
2 1 2 1 2 0 2 0 2 1 2 1 2 0 2
2 0 0 1 1 1 1 0 0 0 0 0 1 1 2
2 2 2 2 2 2 2 2 2 2 2 2 2 2 2
7 1
3
0
8 3
2
8 3
6 7
0
1 12
1
4 10
0
13 13
1
8 5